あ	亞	名詞	
あい	愛	名詞サ変	
あうぎ	奧義	名詞	
あうくわ	櫻花	名詞	
あぢ	味	名詞	
あひず	合圖	名詞	
あふ	凹	名詞	
あふ	扇	動詞ガ行五段	
あふぎ	扇	名詞	
あふしう	押收	名詞サ変	
あふとつ	凹凸	名詞	
あやふい	危い	形容詞	
あらそ	爭	動詞ハ行四段	
あらたま	荒魂	組織	
あらたま	荒魂之會	組織	
あれい	啞鈴	名詞	啞（唖）鈴→亜鈴
あを	靑	名詞	
あをい	靑い	形容詞	
あん	闇	名詞	
あんしやう	暗誦	名詞サ変	暗誦→暗唱
あんや	闇夜	名詞	闇夜→暗夜
い	ゐ	動詞ラ行五段	
い	云	動詞ハ行四段	
い	言	動詞ハ行四段	
い	謂	動詞ハ行四段	
いう	有	名詞	
いうぎ	遊戱	名詞	
いうびん	郵便	名詞	
いえ	ゐゑ	名詞	
いえ	ヰヱ	名詞	
いかう	意嚮	名詞	
いしやう	衣裳	名詞	衣裳→衣装
いしやれう	慰藉料	名詞	慰藉料→慰謝料
いしゆく	萎縮	名詞サ変	萎縮→委縮
いじやう	異常	名詞	
いちでふ	一帖	名詞	
いつかくせんきん	一攫千金	名詞	一攫千金→一獲千金
いへ	家	名詞	
いる	ゐる	名詞	
いんえい	陰翳	名詞	陰翳→陰影
いんめつ	湮滅	名詞サ変	湮滅→隠滅
うえる	植ゑる	名詞	
うちう	宇宙	名詞	
うつくしい	美い	形容詞	
えいきう	永久	名詞	
えいごふ	永劫	名詞	
えいごふくわいき	永劫囘歸	名詞	
えいさい	穎才	名詞	穎才→英才
えいち	叡智	名詞	叡智→英知
えいやう	營養	名詞	
えうきう	要求	名詞サ変	
えうねん	幼年	名詞	
えうりやう	要領	名詞	
えんご	掩護	名詞サ変	敵の攻撃から、味方の行動を守ること。
えんご	援護	名詞サ変	困っている人を助け守ること。
おうべい	歐米	名詞	
おく	奧	名詞	
おくせつ	臆説	名詞	
おくそく	臆測	名詞	
おくびやう	臆病	名詞形動	臆病→憶病
おんぎ	恩誼	名詞	恩誼→恩義
か	買	動詞ハ行四段	
かいかつ	快活	抑制単語	快濶→快活（國）
かいきふ	階級	名詞	
かいけふ	海峽	名詞	
かいてん	回転	抑制単語	廻転→回転（國）
かいはう	解放	名詞サ変	
かいふく	回復	抑制単語	恢復→回復（國）
かいめつ	壊滅	抑制単語	潰滅→壊滅（國）
かいらん	壊乱	抑制単語	潰乱→壊乱（國）
かいろう	回廊	抑制単語	廻廊→回廊（國）
かう	黃	名詞	
かううんき	耕耘機	名詞	耕耘機→耕運機（新）
かうかつ	硬骨	名詞	{魚更}骨→硬骨（國）
かうぎ	講義	名詞	
かうくわん	交驩	名詞サ変	交驩→交歓（國）
かうこつ	{魚更}骨	名詞	{魚更}骨→硬骨（國）
かうさ	交叉	名詞サ変	交叉→交差（國）
かうさてん	交叉點	名詞	
かうしん	亢進	名詞サ変	昂進・亢進→高進（新）
かうしん	昂進・	名詞サ変	昂進・亢進→高進（新）
かうせい	甦生	名詞サ変	甦生→更正（國）
かうせふ	交涉	名詞サ変	
かうでん	香奠	名詞	香奠→香典（國）
かうとう	昂騰	名詞サ変	昂騰→高騰（國）
かうふん	亢奮	名詞サ変	昂(亢)奮→興奮（國）
かうふん	昂奮	名詞サ変	昂(亢)奮→興奮（國）
かうや	曠野	名詞	曠野→広野
かうやう	昂揚	名詞サ変	昂揚→高揚（國）
かうわ	媾和	名詞サ変	
かえん	火焰	名詞	火焰（焔）→火炎
かくかう	恰好	名詞	恰好→格好（新）
かくぜん	劃然	名詞	劃然→画然（國）
かくぜん	画然	抑制単語	劃然→画然（國）
かくとう	挌闘	名詞	挌闘→格闘
かくとう	格闘	抑制単語	挌闘→格闘（國）
かげろう	かげろう→かげろふ	名詞	
かっきてき	画期的	抑制単語	劃期的→画期的（國）
かっこう	格好	抑制単語	恰好→格好（新）
かっぱつ	活発	抑制単語	活溌→活発（國）
かっぷく	格幅	抑制単語	恰幅→格幅（新）
かつかう	恰好	名詞形動	恰好→格好（新）
かつぱつ	活潑	名詞形動	活潑（溌）→活発
かつぷく	恰幅	名詞	恰幅→格幅（新）
かでう	箇条	名詞	
かでうがき	箇条書	名詞	箇条書き→個条書き
かは	川	名詞	
かふおつ	甲乙	名詞	
かふおつへいてい	甲乙丙丁	名詞	
かんがい	干害	抑制単語	旱害→干害（國）
かんがい	旱害	名詞	旱害→干害（國）
かんけつ	間歇	名詞	間歇→間欠（國）
かんけつ	間欠	抑制単語	間歇→間欠（國）
かんげん	管弦	抑制単語	
かんげんがく	管弦楽	抑制単語	管絃楽→管弦楽（國）
かんじやう	感情	名詞	
かんじん	肝心	抑制単語	肝腎→肝心（國）
かんじん	肝腎	名詞形動	肝腎→肝心（國）
かんじんかなめ	肝心要	抑制単語	
かんじんかなめ	肝腎要	名詞	
かんすう	函數	名詞	函数→関数
かんすう	関数	抑制単語	
かんてん	干天	抑制単語	旱天→干天（國）
かんてん	旱天	名詞	旱天→干天（國）
かんりう	乾溜	名詞	乾溜→乾留（國）
かんりゅう	乾留	抑制単語	乾溜→乾留（國）
かんろく	貫禄	抑制単語	貫禄→貫録（新）
かんろく	貫録	抑制単語	貫禄→貫録（新）
かんばつ	旱魃	名詞	
がう	號	名詞	
がういん	强引	名詞形動	
がうけつ	豪傑	名詞	
がうよく	強慾	名詞形動	強慾→強欲（國）
がくもん	學問	名詞	
がふ	業	名詞	
げふ	業	名詞	
がふどう	合同	名詞	
がふべん	合辦	名詞サ変	合辦（辛二つの間に力）→合弁
き	黃	名詞	
きうか	休暇	名詞	
きうせき	舊蹟	名詞	旧蹟→旧跡（國）
きうめい	糺明	名詞サ変	糺明→糾明（國）
きうやう	休養	名詞サ変	
きうりよう	丘陵	名詞	
きえん	気炎	抑制単語	気焔→気炎（國）
きえん	気焔	名詞	気焔→気炎（國）
きかく	企画	抑制単語	企劃→企画（國）
きき	嬉々	名詞	嬉々→喜々
きくわく	企劃	名詞サ変	
きくわん	稀覯	名詞	
きけい	奇形	抑制単語	畸形→奇形（國）
きけい	畸形	名詞	畸形→奇形（國）
きげんそ	希元素	抑制単語	稀元素→希元素（國）
きげんそ	稀元素	名詞	稀元素→希元素（國）
きしゃく	希釈	抑制単語	稀釈→希釈（國）
きしやう	徽章	名詞	身分・資格・所屬團體などを表すために、衣服・帽子などにつけるしるしのこと。
きしやう	記章	名詞	記念として參加者・關係者に與へるしるしのこと。
きしやく	稀釋	名詞サ変	稀釈→希釈（國）
きしょう	希少	抑制単語	稀＊少→希少（國）
きせう	稀少	名詞形動	稀少→希少（國）
きせき	奇跡	抑制単語	奇蹟→奇跡（國）
きそん	棄損	抑制単語	毀損→棄損（新）
きそん	毀損	名詞サ変	毀損→棄損
きたい	希代	抑制単語	稀代→希代（國）
きたい	稀代	名詞	稀代→希代（國）
きだん	奇談	抑制単語	綺談→奇談（國）
きだん	綺談	名詞	巧みに作られた、面白い話のこと。
きち	機智	名詞	機智→機知（國）
きち	機知	抑制単語	機智→機知（國）
きっすい	喫水	抑制単語	吃水→喫水（國）
きつきよう	吉凶	名詞	
きつすい	吃水	名詞	吃水→喫水（國）
きのふ	昨日	名詞	
きはく	希薄	抑制単語	稀薄→希薄（國）
きはく	気迫	抑制単語	気魄→気迫（新）
きはく	氣魄	名詞	気魄→気迫（新）
きはく	稀薄	名詞形動	稀薄→希薄（國）
きばう	希望	名詞	
きふだい	及第	名詞サ変	
きふむ	急務	名詞	
きふよ	給與	名詞	
きべん	奇弁	抑制単語	詭弁→奇弁（新）
きべん	危弁	抑制単語	詭弁→危弁（新）
きべん	詭辯	名詞	詭弁→奇弁・危弁（新）
きやうえん	饗宴	名詞	饗宴→供宴（新）
きやうこ	鞏固	名詞	鞏固→強固（國）
きやうさう	競爭	名詞サ変	
きやうだい	兄弟	名詞	
きやうだい	鏡臺	名詞	
きやうとうほ	橋頭堡	名詞	橋頭堡→橋頭保（新）
きやうぶん	經文	名詞	
きやうわう	饗應	名詞サ変	饗応→供応（國）
きゅうせき	旧跡	抑制単語	旧蹟→旧跡（國）
きゅうだん	糾弾	抑制単語	糺弾→糾弾
きゅうめい	糾明	抑制単語	糺明→糾明（國）
きゆうきよく	嬉遊曲	名詞	嬉遊曲→喜遊曲
きゆうじゆつ	弓術	名詞	
きゆうでん	宮殿	名詞	
きょうえん	供宴	抑制単語	饗宴→供宴（新）
きょうおう	供応	抑制単語	饗応→供応（國）
きょうかい	教戒	抑制単語	教誨→教戒（國）
きょうかん	凶漢	抑制単語	兇漢→凶漢（國）
きょうき	凶器	名詞	兇器→凶器（國）
きょうこ	強固	抑制単語	鞏固→強固（國）
きょうこう	凶行	抑制単語	兇行→凶行（國）
きょうじん	凶刃	名詞	兇刃→凶刃（國）
きょうとうほ	橋頭保	抑制単語	橋頭堡→橋頭保（新）
きょうぼう	凶暴	抑制単語	兇暴→凶暴（國）
きょしゅつ	拠出	抑制単語	醵出→拠出（他）
きようかう	兇行	名詞	兇行→凶行（國）
きようかん	兇漢	名詞	兇漢→凶漢（國）
きようき	兇器	名詞	兇器→凶器
きようくわう	恐慌	名詞	
きようじん	兇刃	名詞	兇刃→凶刃（國）
きようつう	共通	名詞形動	
きようばう	兇暴	名詞形動	兇暴→凶暴（國）
きようふ	恐怖	名詞	
きようへん	兇變	名詞	兇変→凶変（國）
きようみ	興味	名詞	
きようやく	共軛	名詞形動	共軛→共役
きよきん	醵金	名詞	醵金→拠金
きよしゆつ	醵出	名詞サ変	醵出→拠出（他）
きりうさん	稀硫酸	名詞	稀硫酸→希硫酸（國）
きりゅうさん	希硫酸	抑制単語	稀硫酸→希硫酸（國）
きんこ	禁固	抑制単語	禁錮→禁固（新）
きんこ	禁錮	名詞	禁錮→禁固（新）
きんせい	均整	抑制単語	均斉→均整（新）
きんせい	均斉	名詞	均斉→均整（新）
ぎうにゆう	牛乳	名詞	
ぎえん	義捐	名詞	義捐→義援
ぎえんきん	義捐金	名詞	義捐金→義援金（新）
ぎえんきん	義援金	抑制単語	義捐金→義援金（新）
ぎやうてん	仰天	名詞サ変	
ぎょしゃ	御者	抑制単語	馭者→御者（國）
ぎょろう	魚労	抑制単語	魚撈→魚労（國）
ぎよ	馭	名詞サ変	
ぎようしふ	凝集	名詞サ変	
ぎよしや	馭者	名詞	馭者→御者（國）
ぎよらう	魚撈	名詞	魚撈→魚労（國）
ぎりやう	伎倆	名詞	伎倆（技倆）→技量（國）
ぎりょう	技量	抑制単語	技倆→技量（國）
ぎんしょう	吟唱	抑制単語	吟誦→吟唱（國）
ぎんしよう	吟誦	名詞サ変	吟誦→吟唱（國）
ぎゔせき	紡績	名詞	
くかく	区画	抑制単語	区劃→区画（國）
くくわく	區劃	名詞	区劃→区画（國）
くっさく	掘削	抑制単語	掘鑿→掘削（國）
くつさく	掘鑿	名詞サ変	掘鑿→掘削（國）
くなう	苦惱	名詞	
くわいき	囘歸	名詞	
くわいくわつ	快濶	名詞形動	快濶→快活（國）
くわいてん	廻転	名詞	廻転→回転
くわいてん	廻轉	名詞サ変	廻転→回転（國）
くわいふく	恢復	名詞サ変	恢復→回復（國）
くわいめつ	壞滅	抑制単語	こはれて滅びること
くわいめつ	潰滅	名詞サ変	負けて滅びること
くわいゆう	囘游	名詞サ変	回游→回遊
くわいらう	廻廊	名詞	廻廊→回廊（國）
くわいらん	壞亂	名詞サ変	やぶれ亂れること
くわいらん	潰亂	名詞サ変	ちりぢりに亂れること
くわう	光	名詞	
くわうげふ	礦業	名詞	礦業→鉱業（國）
くわうごう	皇后	名詞	
くわうさう	宏壯	名詞形動	宏壮→広壮（國）
くわうせき	礦石	名詞	礦石→鉱石（國）
くわうせん	光線	名詞	
くわうたいし	皇太子	名詞	
くわうだい	宏大	名詞形動	宏大→広大（國）
くわうだい	廣大	名詞形動	
くわうはん	廣汎	名詞形動	広汎→広範（國）
くわうや	曠野	名詞	曠野→広野（國）
くわえん	火炎	抑制単語	火焔→火炎（國）
くわえん	火焔	名詞	火焔→火炎（國）
くわえんだいこ	火焔太鼓	名詞	
くわく	劃	名詞	
くわくきてき	劃期的	名詞形動	劃期的→画期的（國）
くわくぜん	劃然	名詞	劃然→画然（國）
くわじ	火事	名詞	
くわんいう	勸誘	名詞	
くわんげい	歡迎	名詞	
くわんげん	管絃	名詞	
くわんげんがく	管絃樂	名詞	管絃楽→管弦楽（國）
くわんすう	關數	抑制単語	
くわんろく	貫禄	名詞	貫禄→貫録（新）
くんかい	訓戒	抑制単語	訓誡→訓戒（國）
くんかい	訓誡	名詞サ変	訓誡→訓戒（國）
くんじょう	薫蒸	抑制単語	燻蒸→薫蒸（新）
くんじよう	燻蒸	名詞サ変	燻蒸→薫蒸（新）
くんせい	燻製	名詞	燻製→薫製（國）
くんせい	薫製	抑制単語	燻製→薫製（國）
ぐわいこく	外國	名詞	
ぐわうおん	轟音	名詞	
ぐわか	畫家	名詞	
ぐわつ	月	名詞	
けいくわく	計劃	名詞サ変	
けいけん	敬虔	名詞形動	敬虔→敬謙（新）
けいけん	敬謙	抑制単語	敬虔→敬謙（新）
けいさう	繋爭	名詞	繋争→係争（國）
けいせん	係船	抑制単語	繋船→係船（國）
けいせん	繋船	名詞	繋船→係船（國）
けいそう	係争	抑制単語	繋争→係争（國）
けいぞく	係属	抑制単語	繋属→係属（國）
けいぞく	繋屬	名詞	繋属→係属（國）
けいりう	繋留	名詞	繋留→係留（國）
けいりゅう	係留	抑制単語	繋留→係留（國）
けういく	敎育	名詞サ変	
けうかい	教誡	名詞サ変	教へ戒めること。ただ、実際にはこの語はほとんど使われない。
けうせい	矯正	名詞サ変	
けうくわい	教誨	名詞サ変	（受刑者などに）教え諭すこと。
けっかい	決壊	抑制単語	決潰→決壊（國）
けっき	決起	抑制単語	蹶起→決起（國）
けつかい	決潰	名詞サ変	決潰→決壊（國）
けつき	蹶起	名詞サ変	蹶起→決起（國）
けつくわ	結果	名詞	
けつくわい	決潰	名詞サ変	
けつべつ	決別	抑制単語	訣別→決別（國）
けつべつ	訣別	名詞サ変	訣別→決別（國）
けふ	今日	名詞	
けふい	脅威	名詞	けふゐ
けふくわい	協會	名詞	
けん	劍	名詞	
けんかう	健康	名詞	
けんかうかつ	肩胛骨	名詞	肩胛骨→肩甲骨
けんそ	嶮岨	名詞形動	嶮岨→険阻（國）
けんそ	険阻	抑制単語	嶮岨→険阻（國）
けんぺいりつ	建蔽率	名詞	建蔽率→建坪率
けんま	研摩	抑制単語	研磨→研摩（國）
けんま	研磨	名詞サ変	研磨→研摩（國）
げきかう	激昂	名詞サ変	激昂→激高（新）
げきこう	激高	抑制単語	激昂→激高（新）
げこくじやう	下尅上	名詞	下尅上→下克上（國）
げこくじょう	下克上	抑制単語	下尅上→下克上（國）
げっしょく	月食	抑制単語	月蝕→月食（國）
げつしよく	月蝕	名詞	月蝕→月食（國）
げふむ	業務	名詞	
げんか	弦歌	抑制単語	絃歌→弦歌（國）
げんか	絃歌	名詞	絃歌→弦歌（國）
げんきょう	元凶	名詞	元兇→元凶（國）
げんきよう	元兇	名詞	元兇→元凶（國）
げんぜん	儼然	名詞	儼然→厳然（國）
げんぜん	厳然	抑制単語	儼然→厳然（國）
げんわく	幻惑	抑制単語	眩惑→幻惑（新）
げんわく	眩惑	名詞サ変	眩惑→幻惑（新）
こういん	勾引	名詞サ変	勾引→拘引（新）
こういん	拘引	抑制単語	勾引→拘引（新）
こうさ	交差	抑制単語	交叉→交差（國）
こううんき	耕運機	抑制単語	耕耘機→耕運機（新）
こうえふ	紅葉	名詞	
こうかん	交歓	抑制単語	交驩→交歓（國）
こうぎょう	鉱業	抑制単語	礦業→鉱業（國）
こうさてん	交差点	抑制単語	
こうしん	高進	抑制単語	昂進・亢進→高進（新）
こうじょ	控除	抑制単語	扣除→控除（國）
こうせい	更正	抑制単語	更正
こうせき	鉱石	抑制単語	礦石→鉱石（國）
こうそう	広壮	抑制単語	宏壮→広壮（國）
こうだい	広大	抑制単語	宏大→広大（國）
こうぢよ	扣除	名詞サ変	扣除→控除（國）
こうでん	香典	抑制単語	香奠→香典（國）
こうとう	高騰	抑制単語	昂騰→高騰（國）
こうはう	弘報	名詞サ変	弘報→広報（國）
こうはん	広範	抑制単語	広汎→広範（國）
こうや	広野	抑制単語	曠野→広野（國）
こうよう	高揚	抑制単語	昂揚→高揚（國）
こうわ	媾和	名詞サ変	媾和→講和（國）
こうわ	講和	抑制単語	媾和→講和（國）
こえ	こゑ	名詞	
こえ	聲	名詞	聲(こゑ)
こかつ	枯渇	抑制単語	涸渇→枯渇（國）
こかつ	涸渴	名詞サ変	涸渇→枯渇（國）
こき	古希	抑制単語	古稀→古希（國）
こき	古稀	名詞	古稀→古希（國）
こきやう	故鄕	名詞	
こじやう	古城	名詞	
こせき	古跡	抑制単語	古蹟→古跡（國）
こせき	古蹟	名詞	古蹟→古跡（國）
こつかく	骨格	抑制単語	骨骼→骨格（國）
こつかく	骨骼	名詞	骨骼→骨格（國）
こひ	戀	名詞	
こふ	劫	名詞	
こよう	雇傭	名詞サ変	雇傭→雇用（國）
こよう	雇用	抑制単語	雇傭→雇用（國）
こわいろ	聲色	名詞	
こんかう	混淆	名詞	混淆→混交（國）
こんげう	今曉	名詞	
こんこう	混交	抑制単語	混淆→混交（國）
こんぜん	混然	抑制単語	渾然→混然（新）
こんぜん	渾然	名詞	渾然→混然（新）
こんちゆう	昆蟲	名詞	
こんてい	根底	抑制単語	根柢→根底（國）
こんてい	根柢	名詞	根柢→根底
こんめい	昏迷	名詞	道理に暗くて、分別の定まらないこと。
こんめい	混迷	名詞	複雑に入り交じって、見通しがつかないこと。
こんりふ	建立	名詞サ変	
ごうよく	強欲	抑制単語	強慾→強欲（國）
ごびう	誤謬	名詞	
ごんごだうだん	言語道斷	名詞	
さうあん	草案	名詞	
さうがふ	綜合	名詞	
さうくわう	蒼惶	名詞	蒼惶→倉皇（國）
さうこく	相剋	名詞サ変	相剋→相克（國）
さうてい	裝幀	名詞	装釘(幀)→装丁（國）
さうてい	裝釘	名詞	装釘(幀)→装丁（國）
さうめつ	剿滅	名詞サ変	みなごろし
さうめつ	掃滅	名詞サ変	はらひのけほろぼすこと
さうら	候	動詞ハ行四段	
さうらふぶん	候文	名詞	
さくがん	削岩	抑制単語	
さくがん	鑿岩	名詞サ変	鑿岩→削岩
さくがんき	削岩機	抑制単語	鑿岩機→削岩機（新）
さくがんき	鑿岩機	名詞	鑿岩機→削岩機（新）
さくさん	酢酸	抑制単語	醋酸→酢酸（國）
さくさん	醋酸	名詞	醋酸→酢酸（國）
さくそう	錯綜	名詞	
さげふ	作業	名詞	
さたう	砂糖	名詞	
さふわ	揷話	名詞	
さんぎやう	讃仰	名詞サ変	讃仰→賛仰（國）、夫ではなく先
さんぎょう	賛仰	抑制単語	讃仰→賛仰（國）
さんげん	三弦	抑制単語	三絃→三弦（國）
さんげん	三絃	名詞	三絃→三弦（國）
さんさ	三叉	名詞	
さんさ	三差	抑制単語	
さんさろ	三叉路	名詞	三叉路→三差路（新）
さんさろ	三差路	抑制単語	三叉路→三差路（新）
さんじ	讃辞	名詞	讃辞→賛辞（國）
さんじ	賛辞	抑制単語	讃辞→賛辞（國）
さんじふ	丗	数	
さんすい	撒水	名詞	撒水→散水（國）
さんすい	散水	抑制単語	撒水→散水（國）
さんたん	讃嘆	名詞サ変	讃嘆→賛嘆（國）
さんたん	賛嘆	抑制単語	讃嘆→賛嘆（國）
さんび	讃美	名詞サ変	讃美→賛美（國）
さんび	賛美	抑制単語	讃美→賛美（國）
さんぷ	撒布	名詞サ変	撒布→散布（國）
さんぷ	散布	抑制単語	撒布→散布（國）
さんぷず	散布図	抑制単語	
さんぷづ	撒布圖	名詞	
ざう	象	名詞	
ざうがん	象嵌	名詞サ変	象嵌→象眼（國）
ざうしよ	藏書	名詞	
ざし	坐視	名詞サ変	坐視→座視（國）
ざし	座視	抑制単語	坐視→座視（國）
ざしょう	座礁	抑制単語	坐礁→座礁（國）
ざす	坐洲	名詞サ変	坐洲→座州（國）
ざす	座州	抑制単語	坐洲→座州（國）
ざせう	坐礁	名詞サ変	坐礁→座礁（國）
ざっとう	雑踏	抑制単語	雑沓→雑踏（國）
ざつたう	雑沓	名詞	雑沓→雑踏
ざつたふ	雜沓	名詞	雑沓→雑踏（國）
ざふに	雜煮	名詞	
しう	洲	名詞	洲→州（國）
しうい	周圍	名詞	
しうか	蒐荷	名詞	蒐荷→集荷（國）
しうしふ	收集	名詞サ変	寄せ集めること。「ごみの―」
しうしふ	蒐集	名詞サ変	趣味や研究などのために、ある種の物や資料をたくさん集めること。コレクション。
しうにふ	收入	名詞	
しうぶん	秋分	名詞	
しきよく	色慾	名詞	色慾→色欲（國）
しきよく	色欲	抑制単語	色慾→色欲（國）
しげき	刺戟	名詞サ変	刺戟→刺激（國）
しげき	刺激	抑制単語	刺戟→刺激（國）
しせき	史跡	抑制単語	史蹟→史跡（國）
しせき	史蹟	名詞	史蹟→史跡（國）
したい	屍體	名詞	屍体→死体（國）
したい	死体	抑制単語	屍体→死体（國）
しちぐさ	質種	名詞	質種→質草（新）
しちぐさ	質草	抑制単語	質種→質草（新）
しちてんばっとう	七転八倒	抑制単語	七顛八倒→七転八倒（國）
しちてんばつたう	七顛八倒	名詞	七顛八倒→七転八倒（國）
しぢやう	市場	名詞	
しづか	靜	名詞	
しはん	紫斑	名詞	紫斑→紫班（新）
しはん	紫班	抑制単語	紫斑→紫班（新）
しふ	輯	名詞	輯→集（國）
しふか	集荷	抑制単語	蒐荷→集荷（國）
しふちやく	執着	名詞サ変	
しふちやく	執著	名詞サ変	
しふとく	習得	名詞サ変	
しふめい	襲名	名詞サ変	
しほ	鹽	名詞	
しほづけ	鹽漬	名詞	
しぼつ	死歿	名詞サ変	死歿→死沒（國）
しぼつ	死沒	抑制単語	死歿→死沒（國）
しゃりょう	車両	抑制単語	車輌→車両（國）
しやう	正	名詞	
しやうがい	障碍	名詞	障碍→障害（國）
しやうがいしや	障碍者	名詞	
しやうぐわつ	正月	名詞	
しやうさい	詳細	名詞形動	
しやうじょ	陞叙	名詞	陞叙→昇叙
しやうぢき	正直	名詞形動	
しやうばい	商賣	名詞	
しやうへき	牆壁	名詞	かきとかべと
しやうへき	障壁	名詞	妨げとなるもののこと。「関税―」
しやうぼふ	正法	名詞	
しやりやう	車輌	名詞	車輌→車両（國）
しゅうか	集荷	抑制単語	蒐荷→集荷（國）
しゅうしゅう	収集	抑制単語	蒐集→収集（國）
しゅうそく	終息	抑制単語	終熄→終息（國）
しゅうらく	集落	抑制単語	聚落→集落（國）
しゅせき	手跡	抑制単語	手蹟→手跡（國）
しゅんさい	俊才	抑制単語	駿才→俊才（國）
しゅんそく	俊足	抑制単語	駿足→俊足（新）
しゆうけう	宗敎	名詞	
しゆうそく	終熄	名詞サ変	終熄→終息（國）
しゆうち	衆知	名詞	
しゆうらく	聚落	名詞	聚落→集落（國）
しゆうれう	終了	名詞サ変	
しゆぎやう	修行	名詞サ変	
しゆせき	手蹟	名詞	手蹟→手跡（國）
しゆとく	取得	名詞サ変	
しゆんさい	駿才	名詞	駿才→俊才（國）
しゆんそく	駿足	名詞形動	駿足→俊足（新）
しゆんめ	駿馬	名詞	駿馬→俊馬
しょうか	消夏	抑制単語	銷夏→消夏（國）
しょうがい	障害	抑制単語	障碍→障害（國）
しょうがいしゃ	障害者	抑制単語	
しょうさん	称賛	抑制単語	称(賞)讃→称(賞)賛（國）
しょうじょ	昇叙	抑制単語	陞叙→昇叙（國）
しょうそう	焦燥	抑制単語	焦躁→焦燥（國
しょうちん	消沈	抑制単語	銷沈→消沈（國）
しょうへき	障壁	抑制単語	
しょうもう	消耗	抑制単語	
しょかん	書簡	抑制単語	書翰→書簡（國）
しょかんぶん	書簡文	抑制単語	
しょくじりょうほう	食事療法	抑制単語	食餌療法→食事療法（新）
しょくじん	食尽	抑制単語	蝕甚→食尽（國）
しょくよく	食欲	抑制単語	食慾→食欲（國）
しよいう	所有	名詞	
しようかく	昇格	名詞サ変	
しようさん	稱讃	名詞サ変	称(賞)讃→称(賞)賛（國）
しようじよ	陞叙	名詞	陞叙→昇叙（國）
しようだく	承諾	名詞サ変	
しようり	勝利	名詞サ変	
しよかん	書翰	名詞	書翰→書簡（國）
しよかんぶん	書翰文	名詞	
しよくじ	食餌	名詞	たべもの
しよくじれうはう	食餌療法	名詞	食餌療法→食事療法（新）
しよくじん	蝕甚	名詞	蝕甚→食尽（國）
しよくよく	食慾	名詞	食慾→食欲（國）
しれん	試煉	名詞	試煉→試練（國）
しれん	試練	抑制単語	試煉→試練（國）
しわじよう	過剩	名詞形動	
しんしょく	侵食	抑制単語	侵蝕→侵食（國）
しんしょく	浸食	抑制単語	浸蝕→浸食（國）
しんしよく	侵蝕	名詞サ変	侵蝕→侵食（國）
しんしよく	浸蝕	名詞	浸蝕→浸食
しんしよく	浸蝕	名詞サ変	浸蝕→浸食（國）
しんじゅつ	針術	抑制単語	鍼術→針術（國）
しんじゆつ	鍼術	名詞	鍼術→針術（國）
しんせき	眞蹟	名詞	真蹟→真跡（國）
しんせき	真跡	抑制単語	真蹟→真跡（國）
しんちやう	伸暢	名詞サ変	伸暢→伸長（國）
しんちょう	伸長	抑制単語	伸暢→伸長（國）
はんてん	斑点	名詞	斑点→班点
しんとう	浸透	抑制単語	滲透→浸透（國）
しんとう	滲透	名詞サ変	滲透→浸透（國）
しんりゃく	侵略	抑制単語	侵掠→侵略（國）
しんりやく	侵掠	名詞サ変	侵掠→侵略（國）
しんぱく	心搏	名詞	心搏→心拍
じうなん	柔軟	名詞形動	
じしよう	自稱	名詞サ変	
くんかい	訓誡	名詞	訓誡→訓戒
じつかい	十誡	名詞	
じてん	自轉	名詞サ変	
じてんしや	自轉車	名詞	
じふ	十	数	
じふぐわつ	十月	名詞	
じふたい	澁滯	名詞サ変	
じやうぎ	情義	名詞	人情と義理のこと。
じやうぎ	情誼	名詞	人とつきあふ上での人情や誠意のこと。
じやうじゆ	成就	名詞サ変	
じやうず	上手	名詞形動	
じやうぜつ	饒舌	名詞	饒舌→冗舌
じやうたい	狀態	名詞	
じゅんぼく	純朴	抑制単語	醇朴→純朴（新）
じゆうじつ	充實	名詞サ変	
じゆうじゆん	從順	名詞形動	
じゆつご	術語	名詞	
じゆんか	馴化	名詞サ変	馴化→順化
じゆんしゆ	遵守	名詞サ変	遵守→順守
じゆんぼく	醇朴	名詞形動	醇朴→純朴（新）
じょうぜつ	冗舌	抑制単語	饒舌→冗舌（新）
じょうりゅう	蒸留	抑制単語	蒸溜→蒸留（國）
じょうりゅうすい	蒸留水	抑制単語	
じょじょう	叙情	抑制単語	抒情→叙情（國）
じようだん	冗談	名詞	
じようば	乘馬	名詞サ変	
じようりう	蒸溜	名詞サ変	蒸溜→蒸留（國）
じようりうすい	蒸溜水	名詞	
じよじやう	抒情	名詞	抒情→叙情（國）
じんもん	尋問	抑制単語	訊問→尋問（國）
じんもん	訊問	名詞サ変	訊問→尋問（國）
す	吸	動詞ハ行四段	
すいたい	衰退	抑制単語	衰頽→衰退（國）
すいたい	衰頽	名詞サ変	衰頽→衰退（國）
すいたふ	出納	名詞	
すう	數	名詞	
ず	図	抑制単語	
ず	圖	抑制単語	
ずつ	づゝ	名詞	ずつ→づゝ
ずつう	頭痛	抑制単語	
せいぎょ	制御	抑制単語	制馭(禦)→制御（國）
せいぎよ	制禦	名詞サ変	制馭(禦)→制御（國）
せいぎよ	制馭	名詞サ変	制馭(禦)→制御（國）
せいくわつ	生活	名詞	
せいげふ	正業	名詞	
せいざう	製造	名詞	
せいじ	正字	名詞	
せいじせいかな	正字正假名遣	名詞	
せいじやう	正常	名詞	
せいそく	棲息	名詞	ある場所に棲むこと。生物学では動物についていふ。
せいそく	生息	名詞	生きて生活すること。生物学では植物についていふ。
せうか	銷夏	名詞	銷夏→消夏（國）
せうかう	消耗	名詞サ変	
せうがい	生涯	名詞	
せうがく	小學	名詞	
せうきやく	銷卻	名詞サ変	銷却→消却（國）
せうさう	焦躁	名詞サ変	焦躁→焦燥（國
せうせつ	小說	名詞	
せうそく	消息	名詞	
せうちん	銷沈	名詞サ変	銷沈→消沈（國）
せうねん	少年	名詞	
せかいぢゆう	世界中	名詞	
せつぽふ	說法	名詞	
せんえい	先鋭	抑制単語	尖鋭→先鋭（國）
せんえい	尖鋭	名詞形動	尖鋭→先鋭（國）
せんかう	銓考	名詞サ変	しらべ考へること
せんかう	銓衡	名詞サ変	はかり選ぶこと
せんこう	選考	抑制単語	
せんさう	船艙	名詞	船艙→船倉（國）
せんしう	撰修	名詞	撰修→選修
せんしふ	撰集	名詞	撰集→選集
せんじや	撰者	名詞	撰者→選者
せんじやう	洗淨	名詞	仏教で、心身を洗い清めること。
せんじやう	煽情	名詞	煽情→扇情（國）
せんじょう	扇情	抑制単語	煽情→扇情（國）
せんせんきょうきょう	戦々恐々	抑制単語	戦々兢々→戦々恐々（國）
せんせんきようきよう	戰々兢々	名詞	戦々兢々→戦々恐々（國）
せんそう	船倉	抑制単語	船艙→船倉（國）
せんたん	先端	名詞	長い物の一番端の部分。
せんたん	尖端	名詞	尖った物の先の部分。
せんだん	専断	抑制単語	擅断→専断（國）
せんだん	擅斷	名詞サ変	擅断→専断（國）
せんでき	洗滌	名詞	洗って綺麗にすること。
せんどう	扇動	抑制単語	煽動→扇動（國）
せんどう	煽動	名詞サ変	煽動→扇動（國）
せんぺい	先兵	抑制単語	尖兵→先兵（新）
せんぺい	尖兵	名詞	尖兵→先兵（新）
せんぼつ	戦沒	抑制単語	戦歿→戦沒（國）
せんぼつ	戰歿	名詞サ変	戦歿→戦沒（國）
せんりう	川柳	名詞	
ぜうぜつ	饒舌	名詞形動	饒舌→冗舌（新）
ぜっさん	絶賛	抑制単語	絶讃→絶賛（國）
ぜつけう	絶叫	名詞サ変	
ぜつさん	絶讃	名詞サ変	絶讃→絶賛（國）
ぜんくわい	全壊	名詞サ変	まつたくこはれること
ぜんくわい	全潰	名詞サ変	まつたくつぶれること
ぜんしふ	全集	名詞	
そうがふ	綜合	名詞サ変	綜合→総合（國）
そうこう	倉皇	抑制単語	蒼惶→倉皇（國）
そうこく	相克	抑制単語	相剋→相克（國）
そうごう	総合	抑制単語	綜合→総合（國）
そうざい	惣菜	名詞	惣菜→総菜（國）
そうざい	総菜	抑制単語	惣菜→総菜（國）
そうてい	装丁	抑制単語	装釘(幀)→装丁（國）
そこぢから	底力	名詞	
そさう	沮喪	名詞サ変	沮喪→阻喪（國）
そし	沮止	名詞サ変	沮止→阻止（國）
そし	阻止	抑制単語	沮止→阻止（國）
そしよう	訴訟	名詞サ変	
そすい	疎水	抑制単語	疏水→疎水（國）
そすい	疏水	名詞	疏水→疎水（國）
そそう	阻喪	抑制単語	沮喪→阻喪（國）
そつう	疎通	抑制単語	疏通→疎通（國）
そつう	疏通	名詞サ変	疏通→疎通（國）
そめい	疎明	抑制単語	疏明→疎明（國）
そめい	疏明	名詞	いひわけ、疏明→疎明（國）
ぞうがん	象眼	抑制単語	象嵌→象眼（國）
ぞうよ	贈與	名詞サ変	
ぞうを	憎惡	名詞サ変	
ぞく	續	名詞	
ぞくせい	族生	抑制単語	簇生→族生（國）
ぞくせい	簇生	名詞サ変	簇生→族生（國）
たいかふ	太閤	名詞	
たいさう	體操	名詞サ変	
たいしょく	退色	抑制単語	褪色→退色（國）
たいしよく	褪色	名詞	褪色→退色（國）
たいせい	退勢	抑制単語	頽勢→退勢（國）
たいせい	頽勢	名詞	頽勢→退勢（國）
たいとう	台頭	抑制単語	擡頭→台頭（新）
たいとう	擡頭	名詞サ変	擡頭→台頭（新）
たいはい	退廃	抑制単語	頽廃→退廃（國）
たいはい	頽廢	名詞サ変	頽廃→退廃（國）
たいふう	台風	抑制単語	颱風→台風（國）
たいふう	颱風	名詞	颱風→台風（國）
たいやう	太陽	名詞	
たいよく	大慾	名詞	大慾→大欲（國）
たいよく	大欲	抑制単語	大慾→大欲（國）
たう	堂	名詞	
たうくわい	倒潰	名詞サ変	倒れつぶれること、倒潰→倒壊（國）
たうけん	刀劍	名詞	
たうげ	峠	名詞	
たかね	高嶺	名詞	
たかねのな	高嶺の花→高根の花	名詞	高嶺の花→高根の花
たんぐわん	歎願	名詞サ変	歎願→嘆願（國）
たたか	鬭	動詞ハ行四段	
ただ	糺	動詞サ行五段	糺→糾（國）
ただ	糾	抑制単語	糺→糾（國）
たてがき	縦書	抑制単語	
たてがき	縦書き	抑制単語	
たてがき	縱書	名詞サ変	
たふ	答	名詞	
たふしふ	蹈襲	名詞サ変	蹈襲→踏襲（國）
たふべん	答辯	名詞サ変	
たん	歎	動詞ザ変	歎→嘆（國）
たんがん	嘆願	抑制単語	歎願→嘆願（國）
たんくわう	炭礦	名詞	炭礦→炭鉱（國）
たんくわうぶし	炭礦節	名詞	
たんこうぶし	炭鉱節	抑制単語	
たんざ	端坐	名詞サ変	端坐→端座（國）
たんざ	端座	抑制単語	端→端座（國）
たんへん	短篇	名詞	短篇→短編（國）
たんへん	短編	抑制単語	短篇→短編（國）
たんぺん	短篇	名詞	短篇→短編（國）
たんぺん	短編	抑制単語	短篇→短編（國）
たんんこう	炭鉱	抑制単語	炭礦→炭鉱（國）
だいぢやうぶ	大丈夫	名詞	
だいづ	大豆	名詞	
だう	堂	名詞	
だうろ	道路	名詞	
だつりゃく	奪略	抑制単語	奪掠→奪略（國）
だつりやく	奪掠	名詞サ変	奪掠→奪略（國）
だんこ	斷乎	名詞	断乎→断固
だんばう	煖房	名詞	煖房→暖房（國）
だんぼう	暖房	抑制単語	煖房→暖房（國）
だんろ	暖炉	抑制単語	煖炉→暖炉（國）
だんろ	煖炉	名詞	煖炉→暖炉（國）
ちうざう	鑄造	名詞サ変	
ちうしゆつ	抽出	名詞サ変	
ちうせん	抽籤	名詞	抽籤→抽選
ちうせん	抽籤	名詞サ変	抽籤→抽選（新）
ちえ	智慧	名詞	
ちえ	知惠	名詞	ちゑ
ちかぢか	近々	名詞	
ちぢ	縮	動詞マ行五段	
ちのう	智能	名詞	智能→知能（國）
ちのう	知能	抑制単語	智能→知能（國）
ちぼう	智謀	名詞	智謀→知謀（國）
ちぼう	知謀	抑制単語	智謀→知謀（國）
ちやうちん	堤燈	名詞	
ちやうへん	長篇	名詞	長篇→長編（國）
ちゅうかい	注解	抑制単語	註解→注解（國）
ちゅうしゃく	注釈	抑制単語	註釈→注釈（國）
ちゅうせん	抽選	抑制単語	抽籤→抽選（新）
ちゅうもん	注文	抑制単語	註文→注文（國）
ちゆう	蟲	名詞	
ちゆう	註	名詞	註→注（國）
ちゆうあう	中央	名詞	
ちゆうかい	註解	名詞サ変	註解→注解（國）
ちゆうがく	中學	名詞	
ちゆうしやく	註釈	名詞	註釈→注釈
ちゆうしやく	註釋	名詞サ変	註釈→注釈（國）
ちゆうしん	衷心	名詞	
ちゆうたい	繃帯	名詞	
ちゆうもん	注文	名詞サ変	
ちゆうもん	註文	名詞サ変	註文→注文（國）
ちょうかん	鳥観	抑制単語	
ちょうかんず	鳥観図	抑制単語	鳥瞰図→鳥観図（新）
ちょうへん	長編	抑制単語	長篇→長編（國）
ちんじ	椿事	名詞	思ひがけない大変な出來事。
ちんじ	珍事	名詞	めずらしい出來事。
ちんでん	沈殿	抑制単語	沈澱→沈殿（國）
ちんでん	沈澱	名詞サ変	沈澱→沈殿（國）
ぢやうぶ	丈夫	名詞	
ぢしん	地震	名詞	
ぢめん	地面	名詞	
ぢやうせき	定石	名詞	
ぢゆうやく	重役	名詞	
ぢよせい	女性	名詞	
つじせつぽう	辻說法	名詞	
つづき	續	名詞	
つひえ	費	名詞	
つひや	費	動詞サ行五段	
づ	圖	名詞	
づぐわ	圖畫	名詞	
づつ	づゝ	名詞	
づつう	頭痛	名詞	
ていかい	低回	抑制単語	{彳低-イ}徊→低回（國）
ていくわい	低徊	名詞サ変	{彳低-イ}徊→低回（國）
ていしょく	抵触	抑制単語	牴(觝)触→抵触（國）
ていしよく	牴觸	名詞サ変	牴(觝)触→抵触（國）
ていしよく	觝觸	名詞サ変	牴(觝)触→抵触（國）
ていちょう	丁重	抑制単語	鄭重→丁重（國）
ていちよう	鄭重	名詞形動	鄭重→丁重（國）
ていねい	丁寧	抑制単語	叮嚀→丁寧（國）
ていねい	叮嚀	名詞形動	叮嚀→丁寧（國）
ていはく	碇泊	名詞サ変	碇泊→停泊（國）
ていばう	堤防	名詞	
てうかん	鳥瞰	名詞サ変	鳥瞰→鳥観
てうかんづ	鳥瞰圖	名詞	鳥瞰図→鳥観図（新）
てちやう	手帳	名詞	
てつぱう	鐵砲	名詞	
ててふ	手帖	名詞	
てんたう	顛倒	名詞サ変	顛倒→転倒（國）
てんでん	輾轉	名詞サ変	
てんでんはんそく	輾轉反側	名詞	輾転反側→展転反側
てんとう	転倒	抑制単語	顛倒→転倒（國）
てんぷく	転覆	抑制単語	顛覆→転覆（國）
てんぷく	顛覆	名詞サ変	顛覆→転覆（國）
てんまつ	顚末	名詞	
でうちゆう	絛蟲	名詞	絛虫→条虫
でんいう	電郵	名詞	
でんぶ	殿部	抑制単語	臀部→殿部（他）
でんぶ	臀部	名詞	臀部→殿部（他）
でんぷん	殿粉	抑制単語	澱粉→殿粉（他）
でんぷん	澱粉	名詞	澱粉→殿粉（他）
といふ	都邑	名詞	
とうかい	倒壊	抑制単語	倒潰→倒壊（國）
とうしゅう	踏襲	抑制単語	蹈襲→踏襲（國）
とくしふ	特輯	名詞サ変	特輯→特集（國
とくしゅう	特集	抑制単語	特輯→特集（國
とぜつ	杜絶	名詞サ変	杜絶→途絶（國）
とぜつ	途絶	抑制単語	杜絶→途絶（國）
どうえう	童謠	名詞	
どうてん	動顚	名詞サ変	
ないざう	內臟	名詞	
なう	腦	名詞	
なふにふ	納入	名詞サ変	
にうわ	柔和	名詞	
にじふ	廿	数	
にちえう	日曜	名詞	
にっしょく	日食	抑制単語	
につしよく	日蝕	名詞	
にふがく	入學	名詞サ変	
にふりよく	入力	名詞サ変	
にゆうさん	乳酸	名詞	
にんぎやう	人形	名詞	
にんずう	人數	名詞	
ねつきやう	熱狂	名詞サ変	
ねんぐわん	念願	名詞	
のぼ	陞	動詞ラ行五段	陞→昇（國）
はいき	廢棄	名詞サ変	
はいきょ	廃虚	抑制単語	廃墟→廃虚（新）
はいきよ	廢墟	名詞	廃墟→廃虚（新）
はいとく	悖徳	名詞	悖徳→背徳（國）
はいとく	背徳	抑制単語	悖徳→背徳（國）
はいれつ	排列	名詞サ変	
はう	法	名詞	
はうい	包圍	名詞サ変	
はうかう	芳香	名詞	
はうき	抛棄	名詞サ変	抛棄→放棄（國）
はうさう	放送	名詞サ変	
はうじ	捧持	名詞サ変	捧持→奉持
はうじゆん	芳醇	名詞形動	芳醇→芳純（新）
はうたい	繃帶	名詞	繃帯→包帯（國）
はうちやう	庖丁	名詞	庖丁→包丁（國）
はうぶつせん	抛物線	名詞	抛物線→放物線（國）
はうぷつ	抛物	名詞	
はうむ	葬	動詞ラ行五段	
はうりつ	法律	名詞	
はき	破棄	名詞サ変	契約・取り決めなどを一方的に取り消すこと。
はき	破毀	名詞サ変	法律用語で、上級裁判所が、上訴を理由ありと認め原判決を取り消すこと。
はくあ	白堊	名詞	白堊→白亜
はくかう	薄倖	名詞	薄倖→薄幸（國）
はくこう	薄幸	抑制単語	薄倖→薄幸（國）
はくちう	白晝	名詞	
はくどう	搏動	名詞サ変	搏動→拍動
はすい	破摧	名詞サ変	破摧→破砕（國）
はすい	破砕	抑制単語	破摧→破砕（國）
はぢ	恥	名詞	
はっこう	発酵	抑制単語	醗酵→発酵（國）
はつおんびん	撥音便	名詞	
はつかう	醗酵	名詞サ変	醗酵→発酵（國）
はつが	發芽	名詞	
はてんくわう	破天荒	名詞	
はんき	反旗	抑制単語	叛旗→反旗（國）
はなぢ	鼻血	名詞	
はにふ	埴生	名詞	
はふ	法	名詞	
はらん	波乱	抑制単語	波瀾→波乱（新）
はらん	波瀾	名詞形動	波瀾→波乱（新）
はんき	叛旗	名詞	叛旗→反旗（國）
はんぎゃく	叛逆	抑制単語	叛逆→反逆（國）
はんぎやく	叛逆	名詞サ変	叛逆→反逆（國）
はんしょく	繁殖	抑制単語	蕃殖→繁殖（國）
はんしよく	蕃殖	名詞サ変	蕃殖→繁殖（國）
はんてん	斑點	名詞	斑点→班点（新）
はんてん	班点	抑制単語	斑点→班点（新）
はんぱつ	反撥	名詞サ変	反撥→反発（國）
はんぱつ	反発	抑制単語	反撥→反発（國）
はんらん	反乱	抑制単語	叛乱→反乱（國）
はんらん	叛亂	名詞サ変	叛乱→反乱（國）
ばいう	梅雨	抑制単語	黴雨→梅雨（他）
ばいう	黴雨	名詞	黴雨→梅雨（他）
ばいどく	梅毒	抑制単語	黴毒→梅毒（他）
ばいどく	黴毒	名詞	黴毒→梅毒（他）
ばいべん	買辦	名詞	買辦（辛二つの間に力）→買弁
ばうあつ	防遏	名詞	防遏→防圧（新）
ばうがい	妨害	名詞	相手に危害を加えて物事の遂行を妨げること。
ばうがい	妨碍	名詞サ変	道に物を置いて通行を妨げること。
ばうぎよ	防禦	名詞サ変	防禦→防御（國）
ばうだい	厖大	名詞形動	形容動詞で、量や規模が大きいさま。
ばうだい	膨大	動詞サ変	サ変動詞で、膨れて大きくなること。
ばうちやう	膨脹	名詞サ変	膨脹→膨張
ばくろ	暴露	抑制単語	曝露→暴露（國）
ばくろ	曝露	名詞サ変	曝露→暴露（國）
ばっすい	抜粋	抑制単語	抜萃→抜粋（國）
ばつすい	抜萃	名詞サ変	抜萃→抜粋（國）
ばんがう	番號	名詞	
ばんきん	鈑金	名詞	
ばんしう	晩秋	名詞	
ばんぞく	蕃族	名詞	蕃族→蛮族（國）
ばんぞく	蛮族	抑制単語	蕃族→蛮族（國）
ひうが	日向	地名	
ひけつ	秘訣	名詞	
ひご	蜚語	名詞サ変	蜚語→飛語（國）
ひご	飛語	抑制単語	蜚語→飛語（國）
ひさい	菲才	名詞形動	菲才→非才
ひっせき	筆跡	抑制単語	筆蹟→筆跡（國）
ひつせき	筆蹟	名詞	筆蹟→筆跡（國）
ひょうぜん	漂然	抑制単語	飄然→漂然（新）
ひれき	披歴	抑制単語	披瀝→披歴（新）
ひれき	披瀝	名詞サ変	披瀝→披歴（新）
ひろう	披露	名詞サ変	
ひろの	広野	抑制単語	曠野→広野（國）
ひろの	曠野	名詞	曠野→広野（國）
ひんきゆう	貧窮	名詞サ変	
びせう	微笑	名詞サ変	
びは	琵琶	名詞	
びやうき	病氣	名詞形動	
びやうぼつ	病歿	名詞サ変	病歿→病沒（國）
びょうき	病気	抑制単語	
びょうぼつ	病沒	抑制単語	病歿→病沒（國）
びんばふ	貧乏	名詞	
ふ	踏	抑制単語	蹈→踏（國）
ふ	蹈	動詞マ行五段	蹈→踏（國）
ふうくわうめいび	風光明媚	名詞形動	風光明媚→風光明美（新）
ふうこうめいび	風光明美	抑制単語	風光明媚→風光明美（新）
ふうし	諷刺	名詞サ変	諷刺→風刺（國）
ふうし	風刺	抑制単語	諷刺→風刺（國）
ふうゆ	諷喩	名詞	諷喩→風諭
ふえん	布衍	名詞サ変	布衍→敷延（新）
ふえん	敷延	抑制単語	敷衍＊・布衍→敷延（新）
ふえん	敷衍	名詞サ変	敷衍→敷延（新）
ふくろう	ふくろふ	名詞	
ふしやう	負傷	名詞サ変	
ふしょく	腐食	抑制単語	腐蝕→腐食（國）
ふしよく	腐蝕	名詞サ変	腐蝕→腐食（國）
ふちょう	符丁	抑制単語	符牒→符丁（國）
ふてふ	符牒	名詞	符牒→符丁（國）
ふらん	腐乱	抑制単語	腐爛→腐乱（國）
ふらん	腐爛	名詞サ変	腐爛→腐乱（國）
ふんさう	扮裝	名詞サ変	扮装→粉装
ふんそう	粉装	抑制単語	扮装→粉装（新）
ぶかっこう	不格好	抑制単語	不恰好→不格好（新）
ぶかつかう	不恰好	名詞形動	不恰好→不格好（新）
ぶだう	葡萄	名詞	
ぶつざう	佛像	名詞	
ぶつよく	物慾	名詞	物慾→物欲（國）
ぶつよく	物欲	抑制単語	物慾→物欲（國）
ぶんしやう	文章	名詞	
ぶんりゆう	分溜	名詞サ変	分溜→分留
へう	表	名詞	
へうじ	表示	名詞サ変	
へうぜん	飄然	名詞	飄然→漂然（新）
へんきやう	邊疆	名詞	辺疆→辺境（國）
へんきょう	辺境	抑制単語	辺疆→辺境（國）
へんしふ	編輯	名詞サ変	編輯→編集（國）
へんしゅう	編集	抑制単語	編輯→編集（國）
へんずつう	片頭痛	抑制単語	偏頭痛→片頭痛（他）
へんづつう	偏頭痛	名詞	偏頭痛→片頭痛（他）
へんぺい	扁平	名詞	扁平→偏平
べんぱつ	辮髪	名詞	辮髪→弁髪
ほいく	保育	名詞サ変	乳幼児を保護し育てること。
ほいく	哺育	名詞サ変	哺育→保育（國）
ほうかい	崩壊	抑制単語	崩潰→崩壊（國）
ほうき	放棄	抑制単語	抛棄→放棄（國）
ほうきふ	俸給	名詞	
ほうくわい	崩潰	名詞サ変	崩潰→崩壊（國）
ほうしゆく	奉祝	名詞	
ほうじ	奉持	抑制単語	捧持→奉持（新）
ほうじ	捧持	名詞サ変	捧持→奉持（新）
ほうじゅん	芳純	抑制単語	芳醇→芳純（新）
ほうたい	包帯	抑制単語	繃帯→包帯（國）
ほうちょう	包丁	抑制単語	庖丁→包丁（國）
ほうねん	豐年	名詞	
ほうぶつせん	放物線	抑制単語	抛物線→放物線（國）
ほさ	補佐	抑制単語	輔佐→補佐（國）
ほさ	輔佐	名詞サ変	輔佐→補佐（國）
ほさう	鋪裝	名詞サ変	鋪装→舗装（國）
ほそう	舗装	抑制単語	鋪装→舗装（國）
ほだう	輔導	名詞サ変	輔導→補導（國）
ほどう	補導	抑制単語	輔導→補導（國）
ほふえ	法會	名詞	法會(ほふゑ)
ほぼ	保姆	名詞	保姆→保母（國）
ほぼ	保母	抑制単語	保姆→保母（國）
ほるい	保塁	抑制単語	堡塁→保塁（新）
ほるい	堡塁	名詞	堡塁→保塁（新）
ほんぱう	奔放	名詞形動	
ぼうあつ	防圧	抑制単語	防遏→防圧（新）
ぼうがい	妨害	抑制単語	妨碍→妨害（國）
ぼうぎょ	防御	抑制単語	防禦→防御（國）
ぼくじふ	墨汁	名詞	
ぼし	拇指	名詞	拇指→母指（新）
ぼし	母指	抑制単語	拇指→母指（新）
ぼんぢやうちん	盆堤燈	名詞	
まい	まゐ	動詞ラ行五段	
まい	參	動詞ラ行五段	
まうさう	妄想	名詞サ変	妄想→盲想（新）
まうしふ	妄執	名詞サ変	妄執→盲執（新）
まうだう	妄動	名詞サ変	
まうどう	妄動	名詞サ変	妄動→盲動（國）
まうねん	妄念	名詞	妄念→盲念（新）
まかう	磨耗	名詞サ変	磨耗→摩耗（新）
まは	廻	動詞ラ行五段	
まはり	廻	名詞	
まへ	前	名詞	
まめつ	摩滅	抑制単語	磨滅→摩滅（國）
まめつ	磨滅	名詞サ変	磨滅→摩滅（國）
まもう	摩耗	抑制単語	磨耗→摩耗（新）
まわ	廻	動詞ラ行五段	
まんえふしふ	萬葉集	固有名詞	
みだり	濫	名詞形動	
みづ	水	名詞	
みゃくはく	脈拍	抑制単語	脈愽→脈拍（新）
みやくはく	脈愽	名詞	脈愽→脈拍（新）
むし	蟲	名詞	
むち	無智	名詞形動	無智→無知（國）
むち	無知	抑制単語	無智→無知（國）
むよく	無慾	名詞形動	無慾→無欲（國）
むよく	無欲	抑制単語	無慾→無欲（國）
めいび	明媚	名詞	明媚→明美
めいよきそん	名誉棄損	抑制単語	名誉毀損→名誉棄損（新）
めいよきそん	名誉毀損	名詞	名誉毀損→名誉棄損（新）
めいよよく	名誉慾	名詞	名誉慾→名誉欲（國）
めいよよく	名誉欲	抑制単語	名誉慾→名誉欲（國）
めいらう	明朗	名詞形動	
めづらし	珍	形容詞	
めんか	棉花	名詞	棉花→綿花（國）
めんか	綿花	抑制単語	棉花→綿花（國）
もうさう	盲想	抑制単語	妄想→盲想（新）
もうしゅう	盲執	抑制単語	妄執→盲執（新）
もうどう	盲動	抑制単語	妄動→盲動（國）
もうねん	盲念	抑制単語	妄念→盲念（新）
もさく	摸索	名詞サ変	摸索→模索（國）
もさく	模索	抑制単語	摸索→模索（國）
もんだふ	問答	名詞サ変	
やうか	八日	名詞	
やうす	樣子	名詞	
やうやう	洋々	名詞	
やじう	野獸	名詞	
やひ	野卑	抑制単語	野鄙→野卑（國）
やひ	野鄙	名詞形動	野鄙→野卑（國）
ゆう	有	名詞サ変	
ゆうき	勇氣	名詞	
ゆうぎ	友宜	抑制単語	友誼→友宜（新）
ゆうぎ	友誼	名詞	友誼→友宜（新）
ゆうしゅん	優俊	抑制単語	優駿→優俊馬（新）
ゆうしゆん	優駿	名詞	優駿→優俊（新）
ゆうぜん	悠然	名詞	悠然→裕然
ゆくわい	愉快	名詞	
ゆさうせん	油槽船	名詞	油槽船→油送船（新）
ゆそうせん	油送船	抑制単語	油槽船→油送船（新）
ゆふ	夕	名詞	
ゆふがた	夕方	名詞	
ようかい	溶解	抑制単語	鎔解→溶解（國）
ようかい	鎔解	名詞サ変	鎔解→溶解（國）
ようがん	溶岩	抑制単語	熔岩→溶岩（國）
ようがん	熔岩	名詞	熔岩→溶岩（國）
ようせつ	熔接	名詞サ変	熔接→溶接
よく	慾	名詞	慾→欲
よろん	輿論	名詞	輿論→世論（せいろん）
らうか	廊下	名詞	
らうどう	勞働	名詞	
らくご	落伍	名詞サ変	落伍→落後（新）
らくご	落後	抑制単語	落伍→落後（新）
らくばん	落盤	抑制単語	落磐→落盤（國）
らくばん	落磐	名詞	落磐→落盤（國）
らふそく	蠟燭	名詞	
らんくつ	濫掘	名詞サ変	濫掘→乱掘
らんさく	濫作	名詞サ変	濫作→乱作
らんざう	濫造	名詞サ変	濫造→乱造
らんどく	濫讀	名詞サ変	濫読→乱読
らんぱつ	濫發	名詞	濫発→乱発
らんぴ	濫費	名詞サ変	濫費→乱費
らんよう	濫用	名詞サ変	濫用→乱用
らんわう	卵黃	名詞	
りうい	留意	名詞サ変	
りういん	溜飲	名詞	溜飲→留飲（新）
りうかう	流行	名詞サ変	
りうげんひご	流言蜚語	名詞	
りうしゆつ	溜出	名詞	溜出→留出
りえう	俚謡	名詞	俚謡→里謡（國）
りかう	悧巧	名詞形動	心の働がが素早くたくみ
りくつ	理屈	抑制単語	理窟→理屈（國）
りくつ	理窟	名詞	理窟→理屈（國）
りこう	利口	抑制単語	
りち	理智	名詞	理智→理知（國）
りち	理知	抑制単語	理智→理知（國）
りつぱう	立方	名詞	
りつぱうたい	立方體	名詞	
りはん	離反	抑制単語	離叛→離反（國）
りはん	離叛	名詞サ変	離叛→離反（國）
りひう	悧口	名詞形動	口先がたくみ。
りふし	粒子	名詞	
りゃくだつ	略奪	抑制単語	掠奪→略奪（國）
りやうかい	諒解	名詞	まこととして認めること
りやうしよう	諒承	名詞サ変	諒承→了承（國）
りやくだつ	掠奪	名詞サ変	掠奪→略奪（國）
りゅういん	留飲	抑制単語	溜飲→留飲（新）
りゆう	龍	名詞	
りよう	龍	名詞	
りゆうせい	隆盛	名詞	
りょうけん	了見	抑制単語	了簡＊・料簡→了見（新）
りょうしょう	了承	抑制単語	
りよう	里謡	抑制単語	俚謡→里謡（國）
りんかく	輪郭	抑制単語	輪廓→輪郭（國）
りんくわく	輪廓	名詞	輪廓→輪郭（國）
りんじゆう	臨終	名詞	
れいぢやう	令孃	名詞	
れいほう	靈峰	名詞	
れうかい	了解	名詞サ変	能く理解すること
れうけん	了簡	名詞	了簡＊・料簡→了見（新）
れうけん	料簡	名詞	了簡＊・料簡→了見（新）
れうしよう	了承	名詞サ変	うけたまきること
れふじゆう	獵銃	名詞	
れんがふ	聯合	名詞サ変	聯合→連合（國）
れんけい	連係	抑制単語	連繋→連係（國）
れんけい	連繋	名詞サ変	連繋→連係（國）
れんけい	連繫	名詞サ変	連繫（繋）→連係
れんごう	連合	抑制単語	聯合→連合（國）
れんさう	連想	抑制単語	聯想→連想（國）
れんざ	連坐	名詞サ変	連坐→連座（國）
れんざ	連座	抑制単語	連坐→連座（國）
れんじゆ	聯珠	名詞	聯珠→連珠（國）
れんたん	煉炭	名詞	煉炭→練炭（國）
れんたん	練炭	抑制単語	煉炭→練炭（國）
れんにゅう	練乳	抑制単語	煉乳→練乳（國）
れんにゆう	煉乳	名詞	煉乳→練乳（國）
れんぱう	聯邦	名詞	聯邦→連邦（國）
れんぽう	聯峰	名詞	
れんぽう	連邦	抑制単語	聯邦→連邦（國）
れんま	練摩	抑制単語	練磨＊・錬磨→練摩（新）
れんま	練磨	名詞サ変	練磨＊・錬磨→練摩（新）
れんま	錬磨	名詞サ変	練磨＊・錬磨→練摩（新）
れんめい	聯盟	名詞サ変	聯盟→連盟（國）
れんめい	連盟	抑制単語	聯盟→連盟（國）
れんらく	聯絡	名詞サ変	聯絡→連絡（國）
れんらく	連絡	抑制単語	聯絡→連絡（國）
れんりつ	聯立	名詞サ変	聯立→連立（國）
れんりつ	連立	抑制単語	聯立→連立（國）
れんじゅ	連珠	抑制単語	聯珠→連珠（國）
ろう	樓	名詞	
ろうでん	漏電	名詞	
ろくでふ	六疊	名詞	
わう	王	名詞	
わう	黃	名詞	
わうじ	王子	名詞	
わうたいし	おうたいし	名詞	
わうたふ	應答	名詞	
わうらい	往來	名詞	
わけ	訣	名詞	
わけ	訳	抑制単語	
わけ	譯	抑制単語	
わん	彎	名詞	彎→湾（國）
わん	湾	抑制単語	彎→湾（國）
わんきょく	湾曲	抑制単語	彎曲→湾曲（國）
わんきよく	彎曲	名詞サ変	彎曲→湾曲（國）
わんにふ	彎入	名詞サ変	彎入→湾入（國）
わんにゅう	湾入	抑制単語	彎入→湾入（國）
をかん	惡寒	名詞	
をざは	小澤	姓	
をとこ	男	名詞	
をど	踊	動詞ラ行五段	
をんな	女	名詞	
ありう	亞流	名詞	
ありゅう	亜流	抑制単語	
あま	亞麻	名詞	
あま	亜麻	抑制単語	
あねつたい	亞熱帶	名詞	
あねったい	亜熱帯	抑制単語	
あねったい	亜熱帯植物	抑制単語	
あねつたい	亞熱帯植物	名詞	
とうあ	東亞	地名	
とうあ	東亜	抑制単語	
ありうさん	亞硫酸	名詞	
ありゅうさん	亜硫酸	抑制単語	
りうさん	硫酸	名詞	
りゅうさん	硫酸	抑制単語	
あえん	亞鉛	名詞	
あえん	亜鉛	抑制単語	
あじあ	亞細亞	地名	
あじあ	亜細亜	名詞	
つ	亞	動詞ガ行五段	
あみだ	阿彌陀	人名	
あみだ	阿弥陀	抑制単語	
きよくがくあせい	曲學阿世	名詞	
きょくがくあせい	曲学阿世	抑制単語	
あしゆら	阿修羅	人名	
あしゅら	阿修羅	抑制単語	
あびけうくわん	阿鼻叫喚	名詞サ変	
あびきょうかん	阿鼻叫喚	抑制単語	
けうくわん	叫喚	名詞サ変	
きょうかん	叫喚	抑制単語	
おし	啞	名詞	
おし	唖	抑制単語	
あぜん	啞然	名詞	
あぜん	唖然	抑制単語	
まうあ	盲啞	名詞	
もうあ	盲唖	抑制単語	
ろうあ	聾啞	名詞	
ろうあ	聾唖	抑制単語	
かへる	蛙	名詞	
かえる	蛙	抑制単語	
あせい	蛙聲	名詞	
あせい	蛙声	抑制単語	
せいあ	井蛙	名詞	
ああ	嗚呼	感動詞	
ああ	嗟呼	感動詞	
ああ	嗟嗟	感動詞	
ああ	噫呼	感動詞	
あはれ	哀	名詞	
あはれ	哀	動詞マ行五段	
あいぐわん	哀願	名詞サ変	
あいがん	哀願	抑制単語	
あいしう	哀愁	名詞	
あいしゅう	哀愁	抑制単語	
あいしやう	哀傷	名詞サ変	
あいしょう	哀傷	抑制単語	
あいくわん	哀歡	名詞サ変	
あいかん	哀歓	抑制単語	
あいたう	哀悼	名詞サ変	
あいとう	哀悼	抑制単語	
かはいさう	可哀相	名詞形動	
かわいそう	可哀相	抑制単語	
ちり	埃	名詞	
ほこり	埃	名詞	
ぢんあい	塵埃	名詞	
じんあい	塵埃	抑制単語	
あいぢん	埃塵	名詞	
あいじん	埃塵	抑制単語	
あいど	埃土	名詞	
あいめつ	埃滅	名詞	
えじぷと	埃及	地名	
あいさつ	挨拶	名詞	
ひら	挨	動詞カ行五段	
さうあい	相愛	名詞サ変	
そうあい	そうあい	抑制単語	
さうしさうあい	相思相愛	名詞	
そうしそうあい	そうしそうあい	抑制単語	
いとはし	愛	形容詞	
をし	愛	動詞マ行五段	
あいしやう	愛稱	名詞	
あいしょう	愛称	抑制単語	
あいぐわん	愛玩	名詞サ変	
あいがん	愛玩	抑制単語	
あいきやう	愛敬	名詞	
あいぎやう	愛敬	名詞	
あいきょう	愛敬	抑制単語	
あいぎょう	愛敬	抑制単語	
あいどく	愛讀	名詞サ変	
あいどく	愛読	抑制単語	
あいどくしよ	愛讀書	名詞	
あいどくしょ	愛読書	抑制単語	
あいかう	愛好	名詞サ変	
あいこう	愛好	抑制単語	
かはい	可愛	形容詞	
かわい	可愛	抑制単語	
あいるらんど	愛蘭	地名	
せま	隘	形容詞	
けふあい	狭隘	名詞形動	
きょうあい	狭隘	抑制単語	
わらぢ	鞋	名詞	
わらぢ	草鞋	名詞	
わらじ	草鞋	抑制単語	
あいてい	鞋底	名詞	
あいこん	鞋痕	名詞	
したびらめ	鞋底魚	名詞	
したびらめ	舌平目	抑制単語	
いき	噫氣	名詞	
あいを	噫烏	名詞	
あいえつ	噫噎	名詞	
わきあいあい	和氣靄靄	名詞形動	
わあいあい	和気藹々	抑制単語	
わき	和氣	名詞	
わき	和気	抑制単語	
あひきやく	相客	名詞	
あいきゃく	相客	抑制単語	
あひしやう	相性	名詞	
あいしょう	相性	抑制単語	
あひて	相手	名詞	
あいて	相手	抑制単語	
あひかた	相方	名詞	
あいかた	相方	抑制単語	
あひづち	相槌	名詞	
あいずち	相槌	抑制単語	
あひみたがひ	相身互	名詞	
あいみたがい	相身互い	抑制単語	
あひ	相	名詞	
あひ	間	名詞	
あひだ	間	名詞	
あひごま	合駒	名詞	
あいごま	合駒	抑制単語	
まくあひ	幕間	名詞	
まくあい	幕間	抑制単語	
あひきやうげん	間狂言	名詞	
きやうげん	狂言	名詞	
あいきょうげん	間狂言	抑制単語	
きょうげん	狂言	抑制単語	
あひふく	間服	名詞	
あいふく	間服	抑制単語	
あひぎ	間着	名詞	
あいぎ	間着	抑制単語	
あひうち	間打	名詞	
あいうち	間打ち	抑制単語	
あ	合	動詞ハ行四段	
あひづ	合圖	名詞サ変	
あいず	合図	抑制単語	
あひかぎ	合鍵	名詞	
あいかぎ	合鍵	抑制単語	
あひふく	合服	名詞	
あいふく	あいふく	抑制単語	
しあひ	試合	名詞サ変	
しあい	試合	抑制単語	
あ	逅	動詞ハ行四段	
めぐりあひ	邂逅	名詞	
あ	逢	動詞ハ行四段	
あうせ	逢瀬	名詞	
おうせ	逢瀬	抑制単語	
あひびき	逢引	名詞サ変	
あいびき	逢引	抑制単語	
あ	遇	動詞ハ行四段	偶然に遇ふ
あ	遭	動詞ハ行四段	災難に遭ふ
あ	會	動詞ハ行四段	人に會ふ
くわい	會	名詞サ変	
かい	會	抑制単語	
であ	出會	動詞ハ行四段	
であひ	出會	名詞	
であい	出会	抑制単語	
たちあ	立會	動詞ハ行四段	
たちあ	立会	抑制単語	
たちあ	立ち会	抑制単語	
たちあひにん	立會人	名詞	
たちあいにん	たちあいにん	抑制単語	
あへ	喘	動詞ガ行五段	
あえ	喘	抑制単語	重税に喘ぐ
あへて	敢て	名詞	
あえて	敢えて	抑制単語	
あへ	敢	動詞一段	
とりあへず	取敢ず	名詞	
とりあえず	取り敢えず	抑制単語	
あへもの	和物	名詞	
あえもの	和物	抑制単語	
あえもの	和え物	抑制単語	
ごまあへ	胡麻和	名詞	
ごまあえ	胡麻和え	抑制単語	
あへ	和へ	動詞一段	
あをみ	靑み	名詞	
あお	青	抑制単語	
あをじろ	靑白	形容詞	
あをくさ	靑臭	形容詞	
まつさを	眞つ靑	名詞形動	
まっさお	真っ青	抑制単語	
あおにさい	青二才	抑制単語	
あをみ	靑味	名詞	
あおみ	青味	抑制単語	
あをもの	靑物	名詞	
あおもの	青物	抑制単語	
かな	假名	名詞	
かなづかひ	假名遣	名詞	
ふたん	負擔	名詞サ変	
ふたん	負担	抑制単語	
すうがくくわ	數學科	名詞	
すうがく	數學	名詞	
がくせい	學生	名詞	
がくせい	学生	抑制単語	
すうがくか	数学科	抑制単語	
すうがく	数学	抑制単語	
へうげん	表現	名詞サ変	
ひょうげん	表現	抑制単語	
あをいき	靑息	名詞	
あおいき	青息	抑制単語	
あをいきといき	靑息吐息	名詞	
あおいきといき	青息吐息	抑制単語	
あをじやしん	靑寫眞	名詞	
あおじゃし	青写真	抑制単語	
しやしん	寫眞	名詞	
しゃしん	写真	抑制単語	
あをすぢ	靑筋	名詞	
あおすじ	青筋	抑制単語	
すぢ	筋	名詞	
すじ	筋	抑制単語	
あをな	靑菜	名詞	
あおな	青菜	抑制単語	
あを	蒼	形容詞	
あをなみ	蒼波	名詞	
あおなみ	蒼波	抑制単語	
あふ	仰	動詞ガ行五段	
あふむ	仰向	動詞カ行五段	
あおむ	仰向	抑制単語	
あふ	扇	動詞ガ行五段	
あお	扇	抑制単語	
あふぎ	扇	名詞	
おおぎ	扇	抑制単語	
あふ	煽	動詞ラ行五段	
あお	煽	抑制単語	
あか	丹	形容詞	
あか	朱	形容詞	
あけ	朱	名詞	
しゆ	朱	名詞	
しゅ	朱	抑制単語	
まつか	眞赤	名詞形動	
まっか	真っ赤	抑制単語	
あかしんがう	赤信號	名詞	
しんがう	信號	名詞	
あかしんごう	赤信号	抑制単語	
しんごう	信号	抑制単語	
あをしんがう	靑信號	名詞	
あおしんごう	青信号	抑制単語	
あかはぢ	赤恥	名詞	
あかはじ	赤恥	抑制単語	
あか	紅	形容詞	
くれない	くれなゐ	名詞	
みづあか	水垢	名詞	
みずあか	水垢	抑制単語	
あか	銅	名詞	
あか	赫	形容詞	
あかがね	銅	名詞	
あかし	證	名詞	
あか	證	動詞サ行五段	
あかしぶみ	證文	名詞	
あかしびと	證人	名詞	
しようにん	證人	名詞	
あかしぶみ	証文	抑制単語	
あかしびと	証人	抑制単語	
しょうにん	証人	抑制単語	
あかし	燈	名詞	
あかし	灯	抑制単語	
あがた	縣	名詞	
あがた	県	抑制単語	
あがたみ	縣見	名詞	
あがたあるき	縣歩	名詞	
かんたん	簡單	名詞形動	
かんたん	簡単	抑制単語	
つたは	傳は	動詞ラ行五段	
つたへ	傳へ	動詞一段	
あかつき	曉	名詞	
あかつき	暁	抑制単語	
げうあん	曉゛闇	名詞	
ぎょうあん	暁闇	抑制単語	
げう	曉	名詞	
ぎょう	暁	抑制単語	
あかつきおき	曉起	名詞	
あがな	贖	動詞ハ行四段	
あがな	購	動詞ハ行四段	
あがなひもの	贖物	名詞	
あがなひもの	贖者	名詞	
あが	擧が	動詞ラ行五段	
あげ	擧げ	動詞一段	
あげあし	擧げ足	名詞	
あげく	擧げ句	名詞	
あが	騰	動詞ラ行五段	
あきな	商	動詞ハ行四段	
あきもの	商物	名詞	
あきなひ	商	名詞	
あき	厭	動詞一段	
あく	惡	名詞	
あく	悪	抑制単語	
わる	惡	抑制単語	
わる	悪	名詞	
を	惡	名詞	
ぞうを	憎惡	名詞サ変	
ぞうお	憎悪	抑制単語	
ぜんあく	善惡	名詞	
ぜんあく	善悪	抑制単語	
あくじ	惡事	名詞	
あくじ	悪事	抑制単語	
ふくひつ	惡筆	名詞	
あくひつ	悪筆	抑制単語	
あくい	惡意	名詞	
あくい	悪意	抑制単語	
こころ	意	名詞	
こころ	義	名詞	
しうあく	醜惡	名詞形動	
しゅうあく	醜悪	抑制単語	
あくにん	惡人	名詞	
あくに	悪人	抑制単語	
あくせんくとう	惡戰苦鬭	名詞	
あくせんくとう	悪戦苦闘	抑制単語	
あくせん	惡戰	名詞サ変	
あくせん	悪戦	抑制単語	
くとう	苦鬭	名詞サ変	
くとう	苦闘	抑制単語	
あくかんじやう	惡感情	名詞	
あくかんじょう	悪感情	抑制単語	
あくせん	惡錢	名詞	
あくせん	悪銭	抑制単語	
かうを	好惡	名詞	
こうお	好悪	抑制単語	
ぞうを	憎惡	名詞サ変	
かうせい	校正	名詞サ変	
ぞうお	増悪	抑制単語	
こうせい	校正	抑制単語	
とばり	幄	名詞	
あく	幄	名詞	
とばりのざ	幄の座	名詞	
あくざ	幄座	名詞	
あくしや	幄舍	名詞	
や	舍	名詞	
あくばく	幄゛幕	名詞	
あく	渥	名詞	
うるほ	渥	動詞ハ行四段	
あつ	渥	形容詞	
あくぜん	渥然	名詞	
あくおん	渥恩	名詞	
いうあく	優渥	名詞	
あくたく	渥澤	名詞	
いう	優	名詞	
さは	澤	名詞	
さわ	沢	抑制単語	
さわ	澤	抑制単語	
あくりよく	握力	名詞	
あくりょく	握力	抑制単語	
あくしゆ	握手	名詞サ変	
あくしゅ	握手	抑制単語	
しやうあく	掌握	名詞サ変	
しょうあく	掌握	抑制単語	
あくび	欠	名詞	
あげつら	論	動詞ハ行四段	
あさ	淺	形容詞	
あささ	淺さ	名詞	
あさまし	淺まし	形容詞	
あさましさ	淺ましさ	名詞	
あさましげ	淺ましげ	名詞形動	
あさめ	淺め	名詞	
あさしか	淺はか	名詞形動	
あさ	浅	抑制単語	
あさまし	浅まし	抑制単語	
あさましさ	浅ましさ	抑制単語	
あさましげ	浅ましげ	抑制単語	
あさめ	浅め	抑制単語	
あさはか	浅はか	抑制単語	
あさみどり	淺緑	名詞	
あさみどりいろ	淺緑色	名詞	
あさみどり	浅緑	抑制単語	
あさみどりいろ	浅緑色	抑制単語	
あさぎ	淺葱	名詞	
あさぎ	淺黄	名詞	
あさぎ	浅葱	抑制単語	
あさぎ	浅黄	抑制単語	
ついて	就て	名詞	
ついて	就いて	抑制単語	
だいほん	臺本	名詞	
だいほん	台本	抑制単語	
だうにふ	導入	名詞サ変	
どうにゅう	導入	抑制単語	
へう	票	名詞	
あざな	あざな	動詞ハ行四段	
あし	惡	名詞	
あぢ	味	名詞	
あぢは	味は	動詞ハ行四段	
あじわ	味わ	抑制単語	
あじ	味	抑制単語	
あぢけ	味氣	名詞	
あじけ	味気	抑制単語	
あぢみ	味見	名詞サ変	
あじみ	あじみ	抑制単語	
しほあぢ	鹽味	名詞	
しおあじ	塩味	抑制単語	
あぢつけ	味付	名詞	
あじつけ	味付け	抑制単語	
あじつけ	味付	抑制単語	
あしら	配	動詞ハ行四段	
あしら	遇	動詞ハ行四段	
あづか	預か	動詞ラ行五段	
あずか	預か	抑制単語	
あづけ	預け	動詞一段	
あずけ	預け	抑制単語	
あづか	與	動詞ラ行五段	
あずか	与	抑制単語	
あづま	東	名詞	
あずま	東	抑制単語	
あづまをどり	東踊	名詞	
あづまをとこ	東男	名詞	
あずまおどり	東踊り	抑制単語	
あずまおとこ	東男	抑制単語	
きやうをんな	京女	名詞	
きょうおんな	京女	抑制単語	
あぜ	校	名詞	
あぜがや	畦茅	名詞	
あたひ	價	名詞	
あたい	価	抑制単語	
あたひ	値	名詞	
あたい	値	抑制単語	
あた	能	動詞ハ行四段	
あたへ	與へ	動詞一段	
あたえ	与え	抑制単語	
あたかも	宛も	名詞	
あたたか	溫か	形容詞	
あたたか	溫か	名詞形動	
おんど	溫度	名詞	
おんど	温度	抑制単語	
おんだん	溫煖	名詞形動	
おんだん	溫暖	名詞	
おんだん	温暖	抑制単語	
あたたか	煖か	名詞形動	
おんせん	溫泉	名詞	
おんせん	温泉	抑制単語	
あたため	煖め	動詞一段	
あたり	邊	名詞	
あて	當	名詞	
あた	当た	抑制単語	
きし	軋	動詞ラ行五段	
あつか	扱	動詞ハ行四段	
しふ	集	名詞	
べん	辨	名詞	わかち。わきまへ。あつかひ。
べん	辯	名詞	いひまはし。言葉遣。口先が巧みなこと。
べん	瓣	名詞	はなびら。なかご。機械のベン。
べん	辧	名詞	なす、力を致すこと。そなふ、そなはる。
べん	辮	名詞	くむ。あむ。
あつらへ	誂へ	動詞一段	
あつらえ	誂え	抑制単語	
あつらえ	誂	抑制単語	
あて	当て	抑制単語	
もち	十五日	名詞	
れいくわい	例會	名詞	
あな	孔	名詞	
あば	發	動詞カ行五段	
あば	暴	動詞カ行五段	
あぶ	焙	動詞ラ行五段	
あぶれ	溢れ	動詞一段	
じしよ	辭書	名詞	
しよく	食	名詞	
ちやうしよく	朝食	名詞	
ちうしよく	晝食	名詞	
ゆふしよく	夕食	名詞	
ゆふ	夕	名詞	
ゆふひ	夕日	名詞	
やしよく	夜食	名詞	
ちょうしょく	朝食	抑制単語	
ちゅうしょく	昼食	抑制単語	
ゆうしょく	夕食	抑制単語	
やしょく	夜食	抑制単語	
かんしよく	間食	名詞サ変	
かんしょく	間食	抑制単語	
しよくざい	食材	名詞	
しょくざい	食材	抑制単語	
しよくひん	食品	名詞	
しょくひん	食品	抑制単語	
しよくじ	食事	名詞	
しょくじ	食事	抑制単語	
しよせき	書籍	名詞	
いやく	醫藥	名詞	
いやく	医薬	抑制単語	
としや	醫者	名詞	
いしゃ	医者	抑制単語	
くすり	藥	名詞	
くすり	薬	抑制単語	
けいたい	攜帶	名詞サ変	
けいたい	携帯	抑制単語	
けいたいでんわ	攜帶電話	名詞	
けいたいでんわ	携帯電話	抑制単語	
えいぐわ	映畫	名詞	
えいが	映画	抑制単語	
ぐわ	畫	名詞	
が	畫	抑制単語	
かく	畫	名詞	
かく	画	抑制単語	
しゆつりよく	出力	名詞サ変	
せんけい	線形	抑制単語	
へんくわん	變換	名詞サ変	
へんかん	変換	抑制単語	
せつてい	設定	名詞サ変	
のこ	殘	動詞サ行五段	
のこ	残	抑制単語	
ばしよ	場所	名詞	
あたり	當	名詞	
あた	當	動詞ラ行五段	
たう	當	名詞	
たうぶん	當分	名詞	
たうぜん	當前	名詞形動	
あたりまへ	當前	名詞	
とうぶん	当分	抑制単語	
とうぜん	当然	抑制単語	
あたりまえ	当たり前	抑制単語	
たうぎん	當今	名詞	
とうぎん	当今	抑制単語	
たうじ	當時	名詞	
とうじ	当時	抑制単語	
じゆんせいりつ	純正律	名詞	
